13
13
0 0 0 0 0 0 0 0 0 0 0 0 0 
0 0 0 0 0 0 0 0 0 0 0 0 0 
0 0 10 0 0 9 0 0 0 0 0 0 0 
0 0 23 24 24 24 24 25 0 0 0 0 0 
0 0 0 0 0 0 0 0 0 0 0 0 0 
0 0 0 0 0 18 0 0 0 0 0 0 0 
0 0 0 0 0 0 0 0 0 0 0 0 0 
0 0 0 10 0 0 9 0 0 11 0 0 0 
21 21 21 21 21 21 21 21 21 21 21 21 2 
22 22 22 22 22 22 22 22 22 22 22 22 4 
22 22 22 22 22 22 22 22 22 22 22 22 4 
22 22 22 22 22 22 22 22 22 22 22 22 4 
22 22 22 22 22 22 22 22 22 22 22 22 4 
